16
16
XXXXXXXXXXXXXXXX
XX..G....G...XXX
X.....X........X
X...M...A.X.P.XX
X...X..........X
X..X...M...XX..X
X..A.....X..X..X
X......A..A....X
X...XX..M......X
X.....G.A..X...X
X..A......S....X
X...XX..X......X
X...M.....M...XX
X.....M....S...X
X...A.....A...XX
XXXXXXXXXXXXXXXX